#######
#..EGE#
#...#G#
#.G.#.#
#######